WWWWWWWWW
WFFFFFFFW
WFFWWWFFW
WFFWFWFFW
WFFWWWFFW
WFFFFFFFW
WWWWWWWWW
