WWWWWWWWWWW
WFFFFWFFFFW
WFFFFWFFFFW
WFFFFWFFFFW
WWWFWWWFWWW
WFFFFWFFFFW
WFFFFWFFFFW
WWWWWWWWWWW
