WWWWWWWWW
WFFFFFFFW
WFFFFFFFW
WFFWFFFFW
WFFWFFFFW
WFFFFFFFW
WWWWFWWWW
