WWWWWW
WFFFFW
WFFFFW
WFFFFW
WWFWWW
